IDA*
MANHATTAN
      ###
      #.#
  ##### #####
 ##         ##
##  # # # #  ##
#  ##     ##  #
# ##  #$#  ## #
#    .$@$.    #
####  #$#  ####
   ####.####
      ###