IDA*
MANHATTAN
     #####
    ##   #
    #    #
  ###    ######
  #.# # ##    #
### ###  ##   #
#   #     ## ##
#     $@      #
#   #  $  #   #
######   ### ##
 #  .## #### #
 #           #
 ##  #########
  ####