IDA*
MANHATTAN
####### #####
#     # #   #
# ### ### # ###
#             #
### ### # ### #
  # #         #
  # # ####### ###
  # $ #.#@# #   #
  # # # # ### # #
  #   #       # #
  ##### # # # # #
    #   #     # #
    # ### # # # #
    #     #     #
    ####### # # #
          #     #
          #######