A*
MMLB
#######
##.#
## ##
## $##
##@##
#######