A*
MANHATTAN
#######
#     #
#$    #
#     #
#. @  #
#######