GGS
#######
#$    #
#     #
#     #
#.   @#
#######