A*
MMLB
###########
##         ##
#  $     $  #
# $# #.# #$ #
#    # #    #####
#  ###.###  #   #
#  . .@. .      #
#  ###.###  #   #
#    # #    #####
# $# #.# #$ #
#  $     $  #
##         ##
###########