A*
MMLB
################################
#                              #
# $.$               @        . #
#                              #
################################