A*
MANHATTAN
################################
#                              #
# $.$               @        . #
#                              #
################################