A*
MMLB
##########
#.     $ #
# $     .#
# @     $#
#        #
#       .#
##########