IDA*
MMLB
     #####
    ##   #
    #    #
  ###    ######
  #.#.# ##.   #
### ###  ##   #
#   #  $  ## ##
#     $@$     #
#   #  $  #   #
######   ### ##
 #  .## #### #
 #           #
 ##  #########
  ####