IDA*
MMLB
######
##. . ###
#     #
##$  $####
## @ ##
#######
