A*
MMLB
#######
##.  . #
##     ##
##$  $##
##  @  ##
#######

