DFS
      ###
      #.#
  #####.#####
 ##         ##
##  # # # #  ##
#  ##     ##  #
# ##  # #  ## #
#     $@$     #
####  ###  ####
   #### ####