A*
MMLB
######
##. .###
#    #
##$ $####
## @ ##
#######
