IDA*
MMLB
#######
##. #
##$ ##
##@ ##
#######

