A*
MANHATTAN
######
##. ###
##$   ####
##    ##
##   @######
#######
