IDA*
MMLB
      ###
      #.#
  #####.#####
    ###$####
   ##     #
    #  $  #
#####  @  #
##########

