A*
######
## . ###
## $ ####
##    $.##
##@ ######
######
