IDA*
######
##.###
##$####
## ##
##@######
######
