A*

######
##.###
##$###
##@ ##
######