A*
MANHATTAN
######
##.  ###
##$ ####
##  ##
## @######
######
