IDA*

######
## . ###
## $ ###
##    $.##
##@ ######
######
